F 222,10,0
C 30,0,255

WE ./textures/wall3.xpm
EA ./textures/wood.xpm
NO ./textures/wall1.xpm
SO ./textures/wall2.xpm





        111111111111111111111111111
        100000000011000000000000N01
        100000000011110000010000001
        10000000001  11000010000001
        10010000001   1000010000001
11111111101100000111111000000000001
10000000001100000111000011111111111
1000000000000000110000001000101
1010111111111101110101001000111
10000000110101011100000010001
10000000000000001100000010001
10000000000000001101010010001
11000001110101011111011110011
11110111 1110101 101111010001
11111111 1111111 111111111111